0,0,0,0,0,0,0,0,0,0,0,0,0,0,0,0,0,0,0,0,0,0,0,0,0,0,0,0,0,0,0,0,0
0,0,0,0,0,0,0,0,0,0,0,3,0,0,0,0,0,0,0,0,3,0,0,0,0,0,0,0,0,0,0,0,0
1,1,1,1,1,0,0,0,0,0,3,3,3,0,0,0,0,0,0,3,3,3,0,0,0,0,0,0,0,0,0,0,0
1,2,2,2,1,0,0,0,0,3,3,0,3,3,0,0,0,0,3,3,0,3,3,0,0,0,0,0,3,0,0,0,0
1,2,2,2,1,0,0,0,0,3,3,3,3,3,0,0,0,0,3,3,3,3,3,0,0,0,0,3,3,0,0,0,0
1,2,2,2,1,0,0,0,0,3,3,2,3,3,0,0,0,0,3,3,2,3,3,0,0,0,3,3,3,3,0,0,0
1,2,1,1,1,0,0,0,0,3,3,2,3,3,0,0,0,0,3,3,2,3,3,0,0,3,3,3,3,3,0,0,0
1,2,1,0,0,0,0,0,0,0,1,2,1,0,0,0,0,0,0,1,2,1,0,0,0,3,3,2,3,3,0,0,0
1,2,1,1,1,1,1,1,1,1,1,2,1,1,1,1,1,1,1,1,2,1,0,0,0,3,3,2,3,3,0,0,0
1,2,2,2,2,2,2,2,2,2,2,2,2,2,2,2,2,2,1,1,2,1,0,0,0,0,1,2,1,0,0,0,0
1,1,2,1,1,1,1,1,1,1,1,1,1,1,1,1,1,2,1,1,2,1,1,1,1,1,1,2,1,1,1,1,1
0,1,2,1,1,1,1,1,1,1,1,4,4,4,1,1,1,2,2,2,2,2,2,2,2,2,2,2,2,2,2,2,2
0,1,2,2,2,2,2,2,1,1,4,4,4,4,4,1,1,1,1,1,1,1,1,1,1,1,1,1,1,1,1,1,1
0,1,1,1,1,1,1,2,1,4,4,4,4,4,4,4,1,0,0,0,0,0,0,0,0,0,0,0,0,0,0,0,0
0,0,3,0,0,0,1,2,1,4,4,4,4,4,4,4,1,1,0,0,0,0,0,0,0,0,0,0,0,0,0,0,0
0,3,5,3,0,0,1,2,1,4,4,4,4,4,4,4,1,1,0,0,0,0,0,0,3,0,0,0,0,0,0,0,0
3,5,5,5,3,0,1,2,1,1,4,4,4,4,4,4,4,1,0,0,0,0,3,0,3,0,3,0,0,0,0,0,0
3,3,5,3,3,0,1,2,1,1,1,1,4,4,4,4,4,1,0,0,3,0,3,3,3,3,3,0,3,0,0,0,0
3,3,5,3,3,0,1,2,1,0,0,1,1,1,4,4,4,1,1,0,3,3,3,3,3,3,3,3,3,0,0,0,0
3,3,3,3,3,0,1,2,1,0,0,0,0,1,1,4,4,4,1,1,3,3,0,3,3,3,0,3,3,0,0,0,0
3,3,2,3,3,0,1,2,1,1,1,1,1,1,1,1,4,4,4,1,3,3,0,3,2,3,0,3,3,0,0,0,0
3,3,2,3,3,0,1,2,2,2,2,2,2,2,1,1,1,1,4,4,3,3,3,3,2,3,3,3,3,4,0,0,0
0,1,2,1,1,1,1,2,1,1,1,1,1,2,1,1,1,1,4,4,4,4,4,1,2,1,4,4,4,4,4,0,0
0,1,2,2,2,2,2,2,1,1,0,0,1,2,1,1,1,1,1,1,1,1,1,1,2,1,1,1,1,1,1,1,1
3,1,1,1,3,1,1,1,3,1,0,0,1,2,2,2,2,2,2,2,2,2,2,2,2,2,2,2,2,2,2,2,2
3,3,0,3,3,3,0,3,3,1,0,0,1,2,1,1,1,1,1,1,1,1,2,1,1,1,1,1,1,1,1,1,1
3,3,3,3,3,3,3,3,3,1,0,0,1,2,1,1,3,3,3,3,3,1,2,1,3,3,3,3,3,1,0,0,0
3,3,0,3,2,3,0,3,3,1,0,0,1,2,1,1,3,3,2,3,3,1,2,1,3,3,2,3,3,1,0,0,0
3,3,3,3,2,3,3,3,3,1,0,0,1,2,1,1,3,3,2,3,3,1,2,1,3,3,2,3,3,1,0,0,0
0,0,0,1,2,1,1,1,1,1,1,1,1,2,1,1,1,1,2,1,1,1,2,1,1,1,2,1,1,1,0,0,0
0,0,0,1,2,2,2,2,2,2,2,2,2,2,2,2,2,2,2,2,2,2,2,2,2,2,2,1,1,1,0,0,0
0,0,0,1,1,1,1,1,1,1,1,1,1,2,1,1,1,1,1,1,1,1,1,1,1,1,1,1,1,1,0,0,0

NPC
ID=0
name=Vadim
graphics=☺ 
position=1:3

Role=Trader
end

NPC
ID=1
name=Valera
graphics=☻ 
position=3:3

Role=Guard
end

TRIGGER
ID=0
name=Top trigger to right room
graphics= →
position=31:11

remoteRoom=0:1
remotePosition=0:11
end

TRIGGER
ID=1
name=Bottom trigger to right room
graphics= →
position=31:24

remoteRoom=0:1
remotePosition=0:24
end

TRIGGER
ID=2
name=Trigger to bottom room
graphics=↓ 
position=13:31

remoteRoom=1:0
remotePosition=13:0
end

eof